"aa" = (/turf/closed/wall/mineral/titanium,/area/shuttle/escape)
"ab" = (/obj/structure/window/shuttle,/obj/structure/grille,/turf/open/floor/plating,/area/shuttle/escape)
"ac" = (/obj/structure/sign/nanotrasen,/turf/closed/wall/mineral/titanium,/area/shuttle/escape)
"ad" = (/obj/structure/chair/comfy/shuttle{dir = 4},/obj/machinery/newscaster/security_unit{pixel_y = 32},/obj/structure/reagent_dispensers/peppertank{pixel_x = -32},/obj/effect/decal/cleanable/cobweb,/turf/open/floor/mineral/plastitanium/red/brig,/area/shuttle/escape)
"ae" = (/obj/structure/chair/comfy/shuttle,/turf/open/floor/mineral/plastitanium/red/brig,/area/shuttle/escape)
"af" = (/obj/structure/chair/comfy/shuttle{dir = 8},/obj/item/radio/intercom{name = "Station Intercom"; pixel_y = 24},/turf/open/floor/mineral/plastitanium/red/brig,/area/shuttle/escape)
"ag" = (/obj/structure/table/reinforced,/obj/machinery/recharger,/obj/machinery/status_display/evac{pixel_y = 32},/obj/effect/turf_decal/tile/neutral{dir = 1},/obj/effect/turf_decal/tile/neutral,/obj/effect/turf_decal/tile/neutral{dir = 4},/obj/effect/turf_decal/tile/neutral{dir = 8},/obj/effect/spawner/lootdrop/snowdin/weaponrymid,/turf/open/floor/plasteel/facepunch/dark,/area/shuttle/escape)
"ah" = (/obj/machinery/computer/emergency_shuttle,/obj/effect/turf_decal/tile/neutral{dir = 1},/obj/effect/turf_decal/tile/neutral,/obj/effect/turf_decal/tile/neutral{dir = 4},/obj/effect/turf_decal/tile/neutral{dir = 8},/turf/open/floor/plasteel/facepunch/dark,/area/shuttle/escape)
"ai" = (/obj/machinery/computer/communications,/obj/effect/turf_decal/tile/neutral{dir = 1},/obj/effect/turf_decal/tile/neutral,/obj/effect/turf_decal/tile/neutral{dir = 4},/obj/effect/turf_decal/tile/neutral{dir = 8},/turf/open/floor/plasteel/facepunch/dark,/area/shuttle/escape)
"aj" = (/obj/structure/table/reinforced,/obj/item/storage/firstaid/regular,/obj/effect/turf_decal/tile/neutral{dir = 1},/obj/effect/turf_decal/tile/neutral,/obj/effect/turf_decal/tile/neutral{dir = 4},/obj/effect/turf_decal/tile/neutral{dir = 8},/turf/open/floor/plasteel/facepunch/dark,/area/shuttle/escape)
"ak" = (/obj/structure/chair/comfy/shuttle{dir = 4},/obj/machinery/status_display/evac{pixel_x = -32},/obj/machinery/light{dir = 8},/turf/open/floor/mineral/plastitanium/red/brig,/area/shuttle/escape)
"al" = (/turf/open/floor/mineral/plastitanium/red/brig,/area/shuttle/escape)
"am" = (/obj/machinery/door/airlock/command{name = "Emergency Recovery Airlock"; req_access_txt = "19"},/obj/effect/turf_decal/stripes/line{dir = 8},/obj/effect/turf_decal/stripes/line{dir = 4},/turf/open/floor/plasteel,/area/shuttle/escape)
"an" = (/obj/effect/turf_decal/tile/neutral{dir = 1},/obj/effect/turf_decal/tile/neutral,/obj/effect/turf_decal/tile/neutral{dir = 4},/obj/effect/turf_decal/tile/neutral{dir = 8},/turf/open/floor/plasteel/facepunch/dark,/area/shuttle/escape)
"ao" = (/obj/effect/decal/cleanable/dirt,/turf/open/floor/mineral/plastitanium/red/brig,/area/shuttle/escape)
"ap" = (/obj/structure/table/reinforced,/obj/item/storage/fancy/donut_box,/obj/machinery/light{dir = 4},/obj/effect/turf_decal/tile/neutral{dir = 1},/obj/effect/turf_decal/tile/neutral,/obj/effect/turf_decal/tile/neutral{dir = 4},/obj/effect/turf_decal/tile/neutral{dir = 8},/turf/open/floor/plasteel/facepunch/dark,/area/shuttle/escape)
"aq" = (/obj/machinery/door/airlock/shuttle{name = "Emergency Shuttle Airlock"; req_access_txt = "2"},/obj/effect/turf_decal/stripes/line{dir = 8},/obj/effect/turf_decal/stripes/line{dir = 4},/turf/open/floor/plasteel/white,/area/shuttle/escape)
"ar" = (/obj/structure/table/reinforced,/obj/machinery/recharger,/turf/open/floor/mineral/plastitanium/red/brig,/area/shuttle/escape)
"as" = (/obj/item/twohanded/required/kirbyplants{icon_state = "plant-21"; pixel_x = -3; pixel_y = 3},/obj/effect/turf_decal/tile/neutral{dir = 1},/obj/effect/turf_decal/tile/neutral,/obj/effect/turf_decal/tile/neutral{dir = 4},/obj/effect/turf_decal/tile/neutral{dir = 8},/turf/open/floor/plasteel/facepunch/dark,/area/shuttle/escape)
"at" = (/obj/structure/chair/comfy/brown{color = "#596479"; dir = 4},/obj/effect/turf_decal/tile/neutral{dir = 1},/obj/effect/turf_decal/tile/neutral,/obj/effect/turf_decal/tile/neutral{dir = 4},/obj/effect/turf_decal/tile/neutral{dir = 8},/turf/open/floor/plasteel/facepunch/dark,/area/shuttle/escape)
"au" = (/obj/machinery/computer/crew{dir = 8},/obj/machinery/status_display/ai{pixel_x = 32},/obj/effect/turf_decal/tile/neutral{dir = 1},/obj/effect/turf_decal/tile/neutral,/obj/effect/turf_decal/tile/neutral{dir = 4},/obj/effect/turf_decal/tile/neutral{dir = 8},/turf/open/floor/plasteel/facepunch/dark,/area/shuttle/escape)
"av" = (/obj/machinery/door/airlock/security/glass{name = "Holding Area"; req_access_txt = "2"},/turf/open/floor/mineral/plastitanium/red/brig,/area/shuttle/escape)
"aw" = (/obj/machinery/status_display/ai,/turf/closed/wall/mineral/titanium/nodiagonal,/area/shuttle/escape)
"ax" = (/obj/machinery/door/airlock/command/glass{name = "Cockpit"; req_access_txt = "19"},/obj/effect/turf_decal/stripes/line{dir = 2},/obj/effect/turf_decal/stripes/line{dir = 1},/turf/open/floor/plasteel,/area/shuttle/escape)
"ay" = (/obj/machinery/door/airlock/shuttle{name = "Emergency Shuttle Airlock"},/obj/docking_port/mobile/emergency{dheight = 0; dwidth = 5; height = 11; name = "Odd emergency shuttle"; width = 19},/obj/effect/turf_decal/stripes/line{dir = 4},/obj/effect/turf_decal/stripes/line{dir = 8},/turf/open/floor/plasteel/facepunch,/area/shuttle/escape)
"az" = (/obj/effect/turf_decal/stripes/line{dir = 8},/turf/open/floor/plasteel/facepunch,/area/shuttle/escape)
"aA" = (/obj/effect/turf_decal/tile/neutral{dir = 1},/obj/effect/turf_decal/tile/neutral{dir = 4},/turf/open/floor/plasteel/facepunch,/area/shuttle/escape)
"aB" = (/obj/machinery/light{dir = 1},/obj/effect/turf_decal/tile/neutral{dir = 1},/obj/effect/turf_decal/tile/neutral{dir = 4},/turf/open/floor/plasteel/facepunch,/area/shuttle/escape)
"aC" = (/obj/structure/chair/comfy/brown{color = "#596479"; dir = 1},/obj/effect/turf_decal/tile/neutral{dir = 1},/obj/effect/turf_decal/tile/neutral,/obj/effect/turf_decal/tile/neutral{dir = 4},/obj/effect/turf_decal/tile/neutral{dir = 8},/mob/living/simple_animal/hostile/pirate/ranged/space,/turf/open/floor/plasteel/facepunch/dark,/area/shuttle/escape)
"aD" = (/obj/structure/chair/comfy/shuttle{dir = 4},/obj/machinery/status_display/evac{pixel_x = -32},/obj/effect/turf_decal/bot,/turf/open/floor/plasteel/facepunch,/area/shuttle/escape)
"aE" = (/obj/effect/turf_decal/tile/neutral{dir = 1},/obj/effect/turf_decal/tile/neutral,/obj/effect/turf_decal/tile/neutral{dir = 4},/obj/effect/turf_decal/tile/neutral{dir = 8},/turf/open/floor/plasteel/facepunch,/area/shuttle/escape)
"aF" = (/obj/structure/chair/comfy/shuttle{dir = 8},/obj/effect/turf_decal/bot,/turf/open/floor/plasteel/facepunch,/area/shuttle/escape)
"aG" = (/obj/effect/turf_decal/tile/neutral{dir = 1},/obj/effect/turf_decal/tile/neutral{dir = 4},/obj/effect/decal/cleanable/dirt,/turf/open/floor/plasteel/facepunch,/area/shuttle/escape)
"aH" = (/obj/item/clothing/suit/hazardvest{desc = "A high-visibility lifejacket complete with whistle and slot for oxygen tanks."; name = "emergency lifejacket"},/obj/item/clothing/suit/hazardvest{desc = "A high-visibility lifejacket complete with whistle and slot for oxygen tanks."; name = "emergency lifejacket"},/obj/item/clothing/suit/hazardvest{desc = "A high-visibility lifejacket complete with whistle and slot for oxygen tanks."; name = "emergency lifejacket"},/obj/item/clothing/suit/hazardvest{desc = "A high-visibility lifejacket complete with whistle and slot for oxygen tanks."; name = "emergency lifejacket"},/obj/item/clothing/suit/hazardvest{desc = "A high-visibility lifejacket complete with whistle and slot for oxygen tanks."; name = "emergency lifejacket"},/obj/item/tank/internals/emergency_oxygen{pixel_x = 3},/obj/item/tank/internals/emergency_oxygen{pixel_x = 3},/obj/item/tank/internals/emergency_oxygen{pixel_x = 3},/obj/item/tank/internals/emergency_oxygen{pixel_x = 3},/obj/item/tank/internals/emergency_oxygen{pixel_x = 3},/obj/item/clothing/mask/breath{pixel_x = -3; pixel_y = -3},/obj/item/clothing/mask/breath{pixel_x = -3; pixel_y = -3},/obj/item/clothing/mask/breath{pixel_x = -3; pixel_y = -3},/obj/item/clothing/mask/breath{pixel_x = -3; pixel_y = -3},/obj/item/clothing/mask/breath{pixel_x = -3; pixel_y = -3},/obj/item/clothing/head/hardhat/orange{name = "protective hat"; pixel_y = 9},/obj/item/clothing/head/hardhat/orange{name = "protective hat"; pixel_y = 9},/obj/item/clothing/head/hardhat/orange{name = "protective hat"; pixel_y = 9},/obj/item/clothing/head/hardhat/orange{name = "protective hat"; pixel_y = 9},/obj/item/clothing/head/hardhat/orange{name = "protective hat"; pixel_y = 9},/obj/structure/closet/crate/internals,/obj/effect/turf_decal/bot,/turf/open/floor/plasteel/facepunch,/area/shuttle/escape)
"aI" = (/obj/effect/turf_decal/tile/neutral{dir = 1},/obj/effect/turf_decal/tile/neutral,/obj/effect/turf_decal/tile/neutral{dir = 4},/obj/effect/turf_decal/tile/neutral{dir = 8},/obj/structure/chair/comfy/shuttle{icon_state = "shuttle_chair"; dir = 1},/obj/effect/turf_decal/bot,/turf/open/floor/plasteel/facepunch,/area/shuttle/escape)
"aJ" = (/obj/structure/chair/comfy/shuttle{dir = 4},/obj/effect/turf_decal/bot,/turf/open/floor/plasteel/facepunch,/area/shuttle/escape)
"aK" = (/obj/structure/chair/comfy/shuttle{dir = 8},/obj/effect/turf_decal/bot,/obj/machinery/light/small{dir = 4},/turf/open/floor/plasteel/facepunch,/area/shuttle/escape)
"aL" = (/obj/effect/turf_decal/tile/neutral{dir = 1},/obj/effect/turf_decal/tile/neutral{dir = 4},/mob/living/simple_animal/hostile/pirate/melee,/turf/open/floor/plasteel/facepunch,/area/shuttle/escape)
"aM" = (/obj/effect/turf_decal/tile/neutral{dir = 1},/obj/effect/turf_decal/tile/neutral{dir = 4},/obj/effect/decal/cleanable/dirt/dust,/turf/open/floor/plasteel/facepunch,/area/shuttle/escape)
"aN" = (/obj/structure/chair/comfy/shuttle{dir = 4},/obj/effect/turf_decal/bot,/obj/machinery/light/small{dir = 8},/turf/open/floor/plasteel/facepunch,/area/shuttle/escape)
"aO" = (/obj/machinery/door/airlock/public/glass,/obj/effect/turf_decal/tile/facepunch_alt/neutral,/obj/effect/turf_decal/tile/facepunch_alt/neutral{icon_state = "tile_corner"; dir = 8},/obj/effect/turf_decal/tile/facepunch_alt/neutral{icon_state = "tile_corner"; dir = 4},/obj/effect/turf_decal/tile/facepunch_alt/neutral{icon_state = "tile_corner"; dir = 1},/turf/open/floor/plasteel/facepunch/cargo/full,/area/shuttle/escape)
"aP" = (/obj/effect/spawner/lootdrop/mimic_shuttle/midtier,/obj/effect/spawner/lootdrop/maintenance/eight,/obj/effect/turf_decal/tile/facepunch_alt/neutral,/obj/effect/turf_decal/tile/facepunch_alt/neutral{icon_state = "tile_corner"; dir = 8},/obj/effect/turf_decal/tile/facepunch_alt/neutral{icon_state = "tile_corner"; dir = 4},/obj/effect/turf_decal/tile/facepunch_alt/neutral{icon_state = "tile_corner"; dir = 1},/obj/machinery/light{dir = 1},/obj/structure/closet/secure_closet,/turf/open/floor/plasteel/facepunch/cargo/full,/area/shuttle/escape)
"aQ" = (/turf/closed/wall/mineral/titanium/nodiagonal,/area/shuttle/escape)
"aR" = (/obj/machinery/door/airlock/shuttle{name = "Emergency Shuttle Airlock"},/obj/effect/turf_decal/stripes/line{dir = 8},/obj/effect/turf_decal/stripes/line{dir = 4},/turf/open/floor/plasteel/white,/area/shuttle/escape)
"aS" = (/obj/effect/turf_decal/tile/facepunch_alt/neutral,/obj/effect/turf_decal/tile/facepunch_alt/neutral{icon_state = "tile_corner"; dir = 8},/obj/effect/turf_decal/tile/facepunch_alt/neutral{icon_state = "tile_corner"; dir = 4},/obj/effect/turf_decal/tile/facepunch_alt/neutral{icon_state = "tile_corner"; dir = 1},/turf/open/floor/plasteel/facepunch/cargo/full,/area/shuttle/escape)
"aT" = (/obj/effect/spawner/lootdrop/mimic_shuttle/lowtier,/obj/effect/spawner/lootdrop/maintenance/six,/obj/effect/turf_decal/tile/facepunch_alt/neutral,/obj/effect/turf_decal/tile/facepunch_alt/neutral{icon_state = "tile_corner"; dir = 8},/obj/effect/turf_decal/tile/facepunch_alt/neutral{icon_state = "tile_corner"; dir = 4},/obj/effect/turf_decal/tile/facepunch_alt/neutral{icon_state = "tile_corner"; dir = 1},/obj/structure/closet/secure_closet,/turf/open/floor/plasteel/facepunch/cargo/full,/area/shuttle/escape)
"aU" = (/obj/item/radio/intercom{name = "Station Intercom"; pixel_x = 26},/obj/effect/decal/cleanable/cobweb{icon_state = "cobweb2"},/obj/structure/table/reinforced,/obj/item/storage/firstaid,/obj/item/storage/firstaid/brute{pixel_x = 7},/turf/open/floor/plasteel/facepunch,/area/shuttle/escape)
"aV" = (/obj/effect/turf_decal/tile/neutral{dir = 1},/obj/effect/turf_decal/tile/neutral,/obj/effect/turf_decal/tile/neutral{dir = 4},/obj/effect/turf_decal/tile/neutral{dir = 8},/obj/effect/decal/cleanable/dirt/dust,/turf/open/floor/plasteel/facepunch,/area/shuttle/escape)
"aW" = (/obj/structure/chair/comfy/shuttle{dir = 8},/obj/effect/turf_decal/bot,/obj/effect/decal/cleanable/blood/old,/obj/effect/decal/remains/human,/turf/open/floor/plasteel/facepunch,/area/shuttle/escape)
"aX" = (/obj/structure/window{dir = 4},/obj/effect/spawner/lootdrop/mimic_shuttle/lowtier,/obj/effect/spawner/lootdrop/maintenance/two,/obj/effect/turf_decal/tile/facepunch_alt/neutral,/obj/effect/turf_decal/tile/facepunch_alt/neutral{icon_state = "tile_corner"; dir = 8},/obj/effect/turf_decal/tile/facepunch_alt/neutral{icon_state = "tile_corner"; dir = 4},/obj/effect/turf_decal/tile/facepunch_alt/neutral{icon_state = "tile_corner"; dir = 1},/obj/structure/closet/secure_closet,/turf/open/floor/plasteel/facepunch/cargo/full,/area/shuttle/escape)
"aY" = (/obj/structure/window{dir = 8},/obj/effect/spawner/lootdrop/mimic_shuttle/lowtier,/obj/effect/spawner/lootdrop/maintenance/three,/obj/effect/turf_decal/tile/facepunch_alt/neutral,/obj/effect/turf_decal/tile/facepunch_alt/neutral{icon_state = "tile_corner"; dir = 8},/obj/effect/turf_decal/tile/facepunch_alt/neutral{icon_state = "tile_corner"; dir = 4},/obj/effect/turf_decal/tile/facepunch_alt/neutral{icon_state = "tile_corner"; dir = 1},/obj/structure/closet/secure_closet,/turf/open/floor/plasteel/facepunch/cargo/full,/area/shuttle/escape)
"aZ" = (/obj/effect/spawner/lootdrop/mimic_shuttle/lowtier,/obj/effect/spawner/lootdrop/maintenance/two,/obj/effect/turf_decal/tile/facepunch_alt/neutral,/obj/effect/turf_decal/tile/facepunch_alt/neutral{icon_state = "tile_corner"; dir = 8},/obj/effect/turf_decal/tile/facepunch_alt/neutral{icon_state = "tile_corner"; dir = 4},/obj/effect/turf_decal/tile/facepunch_alt/neutral{icon_state = "tile_corner"; dir = 1},/obj/structure/closet/secure_closet,/turf/open/floor/plasteel/facepunch/cargo/full,/area/shuttle/escape)
"ba" = (/obj/effect/spawner/lootdrop/mimic_shuttle/lowtier,/obj/effect/turf_decal/tile/facepunch_alt/neutral,/obj/effect/turf_decal/tile/facepunch_alt/neutral{icon_state = "tile_corner"; dir = 8},/obj/effect/turf_decal/tile/facepunch_alt/neutral{icon_state = "tile_corner"; dir = 4},/obj/effect/turf_decal/tile/facepunch_alt/neutral{icon_state = "tile_corner"; dir = 1},/obj/structure/closet/secure_closet,/turf/open/floor/plasteel/facepunch/cargo/full,/area/shuttle/escape)
"bb" = (/obj/structure/window{dir = 8},/obj/effect/spawner/lootdrop/mimic_shuttle/lowtier,/obj/effect/spawner/lootdrop/maintenance/four,/obj/effect/turf_decal/tile/facepunch_alt/neutral,/obj/effect/turf_decal/tile/facepunch_alt/neutral{icon_state = "tile_corner"; dir = 8},/obj/effect/turf_decal/tile/facepunch_alt/neutral{icon_state = "tile_corner"; dir = 4},/obj/effect/turf_decal/tile/facepunch_alt/neutral{icon_state = "tile_corner"; dir = 1},/obj/structure/closet/secure_closet,/turf/open/floor/plasteel/facepunch/cargo/full,/area/shuttle/escape)
"bc" = (/obj/structure/window{dir = 4},/obj/effect/spawner/lootdrop/mimic_shuttle/lowtier,/obj/effect/turf_decal/tile/facepunch_alt/neutral,/obj/effect/turf_decal/tile/facepunch_alt/neutral{icon_state = "tile_corner"; dir = 8},/obj/effect/turf_decal/tile/facepunch_alt/neutral{icon_state = "tile_corner"; dir = 4},/obj/effect/turf_decal/tile/facepunch_alt/neutral{icon_state = "tile_corner"; dir = 1},/obj/structure/closet/secure_closet,/turf/open/floor/plasteel/facepunch/cargo/full,/area/shuttle/escape)
"bd" = (/turf/closed/wall/mineral/plastitanium,/area/shuttle/escape)
"be" = (/obj/structure/window/reinforced{dir = 1},/obj/structure/shuttle/engine/heater,/obj/effect/turf_decal/stripes/line,/turf/open/floor/plating/airless,/area/shuttle/escape)
"bf" = (/obj/structure/window/reinforced{dir = 1},/obj/structure/shuttle/engine/heater,/obj/effect/decal/cleanable/dirt,/obj/effect/turf_decal/stripes/line,/turf/open/floor/plating/airless,/area/shuttle/escape)
"bg" = (/turf/template_noop,/area/template_noop)
"bh" = (/obj/structure/shuttle/engine/propulsion,/obj/effect/turf_decal/stripes/line,/turf/open/floor/plating/airless,/area/shuttle/escape)
"bi" = (/obj/machinery/door/airlock,/turf/open/floor/mineral/titanium,/area/shuttle/escape)
"bj" = (/obj/structure/window{dir = 8},/obj/effect/spawner/lootdrop/mimic_shuttle/lowtier,/obj/effect/turf_decal/tile/facepunch_alt/neutral,/obj/effect/turf_decal/tile/facepunch_alt/neutral{icon_state = "tile_corner"; dir = 8},/obj/effect/turf_decal/tile/facepunch_alt/neutral{icon_state = "tile_corner"; dir = 4},/obj/effect/turf_decal/tile/facepunch_alt/neutral{icon_state = "tile_corner"; dir = 1},/obj/structure/closet/secure_closet,/turf/open/floor/plasteel/facepunch/cargo/full,/area/shuttle/escape)
"bk" = (/obj/effect/turf_decal/tile/neutral{dir = 1},/obj/effect/turf_decal/tile/neutral,/obj/effect/turf_decal/tile/neutral{dir = 4},/obj/effect/turf_decal/tile/neutral{dir = 8},/obj/effect/decal/cleanable/dirt,/turf/open/floor/plasteel/facepunch,/area/shuttle/escape)
"bl" = (/obj/effect/turf_decal/stripes/line{dir = 8},/turf/open/floor/mineral/titanium,/area/shuttle/escape)
"bm" = (/turf/open/floor/mineral/titanium,/area/shuttle/escape)
"bn" = (/obj/effect/spawner/lootdrop/mimic_shuttle/midtier,/obj/effect/spawner/lootdrop/maintenance/two,/obj/effect/turf_decal/tile/facepunch_alt/neutral,/obj/effect/turf_decal/tile/facepunch_alt/neutral{icon_state = "tile_corner"; dir = 8},/obj/effect/turf_decal/tile/facepunch_alt/neutral{icon_state = "tile_corner"; dir = 4},/obj/effect/turf_decal/tile/facepunch_alt/neutral{icon_state = "tile_corner"; dir = 1},/obj/structure/closet/secure_closet,/turf/open/floor/plasteel/facepunch/cargo/full,/area/shuttle/escape)
"bo" = (/obj/effect/spawner/structure/window/plasma,/turf/open/floor/plating,/area/shuttle/escape)
"bp" = (/obj/machinery/door/airlock/public/glass,/obj/effect/turf_decal/tile/facepunch_alt/neutral{icon_state = "tile_corner"; dir = 1},/obj/effect/turf_decal/tile/facepunch_alt/neutral{icon_state = "tile_corner"; dir = 4},/obj/effect/turf_decal/tile/facepunch_alt/neutral{icon_state = "tile_corner"; dir = 8},/obj/effect/turf_decal/tile/facepunch_alt/neutral,/obj/effect/decal/cleanable/oil/slippery,/turf/open/floor/plasteel/facepunch/cargo/full,/area/shuttle/escape)
"bq" = (/obj/effect/spawner/lootdrop/mimic_shuttle/lowtier,/obj/structure/closet/secure_closet,/turf/open/floor/mineral/titanium,/area/shuttle/escape)
"br" = (/obj/effect/spawner/lootdrop/mimic_shuttle/midtier,/obj/effect/spawner/lootdrop/maintenance/six,/obj/structure/closet/secure_closet,/turf/open/floor/mineral/plastitanium,/area/shuttle/escape)
"bs" = (/obj/effect/spawner/lootdrop/mimic_shuttle/midtier,/obj/effect/spawner/lootdrop/maintenance/two,/obj/effect/decal/cleanable/cobweb{icon_state = "cobweb2"},/obj/structure/closet/secure_closet,/turf/open/floor/mineral/plastitanium,/area/shuttle/escape)
"bt" = (/obj/effect/spawner/lootdrop/mimic_shuttle/lowtier,/obj/effect/spawner/lootdrop/maintenance/three,/obj/structure/closet/secure_closet,/turf/open/floor/mineral/titanium,/area/shuttle/escape)
"bu" = (/obj/effect/spawner/lootdrop/mimic_shuttle/lowtier,/obj/structure/closet/secure_closet,/turf/open/floor/mineral/plastitanium,/area/shuttle/escape)
"bv" = (/obj/effect/spawner/lootdrop/mimic_shuttle/midtier,/obj/machinery/light,/obj/structure/closet/secure_closet,/turf/open/floor/mineral/titanium,/area/shuttle/escape)
"bw" = (/obj/structure/window{dir = 8},/obj/effect/turf_decal/tile/facepunch_alt/neutral,/obj/effect/turf_decal/tile/facepunch_alt/neutral{icon_state = "tile_corner"; dir = 8},/obj/effect/turf_decal/tile/facepunch_alt/neutral{icon_state = "tile_corner"; dir = 4},/obj/effect/turf_decal/tile/facepunch_alt/neutral{icon_state = "tile_corner"; dir = 1},/obj/structure/closet/crate/critter,/obj/effect/spawner/lootdrop/mimic_shuttle/hostile_mobspawner,/obj/effect/spawner/lootdrop/snowdin/weaponrylite,/turf/open/floor/plasteel/facepunch/cargo/full,/area/shuttle/escape)
"bx" = (/obj/effect/spawner/lootdrop/mimic_shuttle/lowtier,/obj/effect/spawner/lootdrop/maintenance/two,/obj/structure/closet/secure_closet,/turf/open/floor/mineral/titanium,/area/shuttle/escape)
"by" = (/obj/effect/spawner/lootdrop/mimic_shuttle/lowtier,/obj/machinery/light,/obj/structure/closet/secure_closet,/turf/open/floor/mineral/titanium,/area/shuttle/escape)
"bz" = (/obj/effect/spawner/lootdrop/mimic_shuttle/lowtier,/obj/effect/spawner/lootdrop/maintenance/two,/obj/machinery/light,/obj/structure/closet/secure_closet,/turf/open/floor/mineral/plastitanium,/area/shuttle/escape)
"bA" = (/obj/effect/spawner/lootdrop/mimic_shuttle/hightier,/obj/structure/closet/secure_closet,/turf/open/floor/mineral/plastitanium,/area/shuttle/escape)
"bB" = (/obj/effect/turf_decal/tile/facepunch_alt/neutral,/obj/effect/turf_decal/tile/facepunch_alt/neutral{icon_state = "tile_corner"; dir = 8},/obj/effect/turf_decal/tile/facepunch_alt/neutral{icon_state = "tile_corner"; dir = 4},/obj/effect/turf_decal/tile/facepunch_alt/neutral{icon_state = "tile_corner"; dir = 1},/mob/living/simple_animal/hostile/pirate/melee,/turf/open/floor/plasteel/facepunch/cargo/full,/area/shuttle/escape)
"bC" = (/obj/structure/window{dir = 4},/obj/effect/turf_decal/tile/facepunch_alt/neutral,/obj/effect/turf_decal/tile/facepunch_alt/neutral{icon_state = "tile_corner"; dir = 8},/obj/effect/turf_decal/tile/facepunch_alt/neutral{icon_state = "tile_corner"; dir = 4},/obj/effect/turf_decal/tile/facepunch_alt/neutral{icon_state = "tile_corner"; dir = 1},/obj/structure/closet/crate/critter,/obj/effect/spawner/lootdrop/mimic_shuttle/hostile_mobspawner,/obj/effect/spawner/lootdrop/snowdin/weaponrymid,/turf/open/floor/plasteel/facepunch/cargo/full,/area/shuttle/escape)
"bD" = (/obj/effect/turf_decal/tile/facepunch_alt/neutral,/obj/effect/turf_decal/tile/facepunch_alt/neutral{icon_state = "tile_corner"; dir = 8},/obj/effect/turf_decal/tile/facepunch_alt/neutral{icon_state = "tile_corner"; dir = 4},/obj/effect/turf_decal/tile/facepunch_alt/neutral{icon_state = "tile_corner"; dir = 1},/obj/effect/decal/cleanable/dirt,/turf/open/floor/plasteel/facepunch/cargo/full,/area/shuttle/escape)
"bE" = (/obj/effect/turf_decal/tile/facepunch_alt/neutral,/obj/effect/turf_decal/tile/facepunch_alt/neutral{icon_state = "tile_corner"; dir = 8},/obj/effect/turf_decal/tile/facepunch_alt/neutral{icon_state = "tile_corner"; dir = 4},/obj/effect/turf_decal/tile/facepunch_alt/neutral{icon_state = "tile_corner"; dir = 1},/obj/effect/decal/cleanable/dirt/dust,/turf/open/floor/plasteel/facepunch/cargo/full,/area/shuttle/escape)
"bF" = (/obj/effect/turf_decal/stripes/line{dir = 8},/obj/effect/turf_decal/tile/facepunch_alt/neutral,/obj/effect/turf_decal/tile/facepunch_alt/neutral{icon_state = "tile_corner"; dir = 8},/obj/effect/turf_decal/tile/facepunch_alt/neutral{icon_state = "tile_corner"; dir = 4},/obj/effect/turf_decal/tile/facepunch_alt/neutral{icon_state = "tile_corner"; dir = 1},/obj/machinery/light,/turf/open/floor/plasteel/facepunch/cargo/full,/area/shuttle/escape)
"bG" = (/obj/effect/turf_decal/tile/facepunch_alt/neutral,/obj/effect/turf_decal/tile/facepunch_alt/neutral{icon_state = "tile_corner"; dir = 8},/obj/effect/turf_decal/tile/facepunch_alt/neutral{icon_state = "tile_corner"; dir = 4},/obj/effect/turf_decal/tile/facepunch_alt/neutral{icon_state = "tile_corner"; dir = 1},/mob/living/simple_animal/hostile/pirate/ranged,/turf/open/floor/plasteel/facepunch/cargo/full,/area/shuttle/escape)
"bH" = (/obj/effect/turf_decal/tile/facepunch_alt/neutral,/obj/effect/turf_decal/tile/facepunch_alt/neutral{icon_state = "tile_corner"; dir = 8},/obj/effect/turf_decal/tile/facepunch_alt/neutral{icon_state = "tile_corner"; dir = 4},/obj/effect/turf_decal/tile/facepunch_alt/neutral{icon_state = "tile_corner"; dir = 1},/obj/machinery/light{dir = 4},/turf/open/floor/plasteel/facepunch/cargo/full,/area/shuttle/escape)
"bI" = (/obj/machinery/door/airlock/vault{req_access_txt = "53"},/turf/open/floor/mineral/plastitanium,/area/shuttle/escape)
"bJ" = (/obj/effect/decal/cleanable/dirt/dust,/turf/open/floor/mineral/titanium,/area/shuttle/escape)
"bK" = (/obj/effect/decal/cleanable/food/tomato_smudge,/obj/effect/decal/cleanable/dirt/dust,/turf/open/floor/mineral/plastitanium,/area/shuttle/escape)
"bL" = (/obj/effect/decal/cleanable/dirt/dust,/turf/open/floor/mineral/plastitanium,/area/shuttle/escape)
"bM" = (/obj/effect/spawner/lootdrop/mimic_shuttle/lowtier,/obj/machinery/light,/obj/structure/closet/secure_closet,/turf/open/floor/mineral/plastitanium,/area/shuttle/escape)
"bN" = (/obj/effect/decal/cleanable/vomit/old,/obj/effect/decal/cleanable/dirt/dust,/turf/open/floor/mineral/titanium,/area/shuttle/escape)
"bO" = (/obj/structure/closet/crate/critter,/obj/effect/spawner/lootdrop/mimic_shuttle/deadly_mobspawner,/obj/effect/spawner/lootdrop/snowdin/weaponrylite,/obj/effect/spawner/lootdrop/snowdin/weaponrymid,/turf/open/floor/mineral/titanium,/area/shuttle/escape)
"bP" = (/obj/structure/closet/crate/critter,/obj/effect/spawner/lootdrop/mimic_shuttle/deadly_mobspawner,/obj/effect/spawner/lootdrop/mimic_shuttle/deadly_mobspawner,/obj/effect/spawner/lootdrop/snowdin/weaponrymid,/obj/effect/spawner/lootdrop/snowdin/weaponryheavy,/turf/open/floor/mineral/plastitanium,/area/shuttle/escape)

(1,1,1) = {"
aaaaababaaacaaabababaa
aaadaeaeafabagahaiajab
aaakaoalalamanaCanapab
aqalaoaoarabasanatauaa
acabavababawabaxabaaac
ayazaGaLaAaBaMaAaMaUaa
aaaDaVaFaIaHaIaJaEaWab
abaJaVaKaaaaaaaNbkaFab
ababbpabaaaPaaabaOabab
abaTaSaXbwbBbCaYbDaZab
aabaaSaXbbbEbcbjaSbnab
aRbFbEaSbEaSaSbDbGbHaa
acaabibiaaaQbobIbIboaa
aRblbJbmbqaQbrbKbLbsaa
aabtbNbJbqaQbubLbLbuaa
aabvbxbObyaQbzbAbPbMaa
aQaaababaaaQaaababaaaQ
bdbdbebfbfbdbfbfbfbdbd
bgbhbhbhbhbdbhbhbhbhbg
"}
